11111111111111111111111
1C01C000000000000000001
10011100000000000000001
1001C000010000011110001
10011100010000000C10001
1000000001C100011110001
1001110001111001C000001
10010100000100011110001
10000100000000000000001
11110100000000000000001
1P0001000000000000000E1
11111111111111111111111
