11111111111111111111111
1Cv1C000000000000000001
10011100000000000000001
1001C000010000011110001
10011100010000000C10001
1000000001C100011110001
1001110001111001C000001
1001v100000100011110001
1^000100000000000001111
1111010000000000000vv01
1P0001000000000000000E1
11111111111111111111111
