11111111111111
10CvCvCvCvCvC1
10000000000001
10000000000001
1P^C^C^C^C^CE1
11111111111111
