1111111111
10000000E1
100CCCC001
1P00000001
1111111111
