NO ./resource/wall_0.xpm
SO ./resource/wall_10.xpm
WE ./resource/wall_3.xpm
EA ./resource/wall_6.xpm

F 162,179,139
C 104,167,173

111111111111
100000000001111111
100000000000000011
1000100N0000011001
111111110000000001
       11111110011
             11111
