NO ./resource/wall_0.xpm
SO ./resource/wall_10.xpm
WE ./resource/door.xpm
EA ./resource/wall_6.xpm

EA ./resource/slin_smile.xpm
NO ./resource/slin.xpm
SO ./resource/slin_red.xpm
WE ./resource/slin_green.xpm

F 162,179,139
C 104,167,173

        1111111111111111111111111
        1000000000110000000000001
        1011000001110000000000001
        1001000000D000000000000W1
111111111011000001110000000000001
100000000011000001110111111111111
11110111111111011100000010001
11110111111111011101010010001
11000000110101011100000010001
10000000000000001100000010001
10000000000000001101010010001
1100000111010101111101111000111
11110111 1110101 101111010001
11111111 1111111 111111111111
