NO ./resource/wall_0.xpm
SO ./resource/wall_10.xpm
WE ./resource/wall_3.xpm
EA ./resource/wall_6.xpm

F 162,179,139
C 104,167,173

1111111
1000001
1001001
1001001
1001001
10000N1
1111111
