11111
100E1
10C01
1P0X1
11111
