11111
100E1
10C01
1P0P1
11111
