11111
100E1
10001
1P001
11111
