NO ./path_to_the_north_texture
SO ./path_to_the_south_texture
WE ./path_to_the_west_texture
EA ./path_to_the_east_texture

F 255,254,253
C 0,1,2

111111111111111111
100000001000000001
100000001000000001
111111111111111111
100000001N00000001
000000001000000001
111111111111111111
