11111
100E1
10C01
1P001
11111
