11111
1E0E1
10C01
1P001
11111
