11111
10001
10C01
1P001
11111
