11111
100E1
10C01
10001
11111
